11111111111111111111111
1E000X00000C00000X000C1
11110000000X00000001111
1P000X00000C00000X000C1
11111111111111111111111
